%%%%%%%%%%%                               %%%                          
%%%%%%%%%%%                               %%%                          
%%%%%%%%%%%%                              %%%                          
%%%%%%%%%%%%                              %%%                          
%%%%%%%%%%%%                              %%%                          
%%%%%%%%%%%%                              %%%                          
%%%%%%%%%%%%                              %%%                          
%%%%%%%%%%%%                              %%%                          
%%%%%%%%%%%%%                             %%%                          
%%%%%%%%%%%%                              %%%                          
%%%%%%%%%%%%                              %%%                          
%%%%%%%%%%%%                              %%%                          
%%%%%%%%%%%%                              %%%                          
%%%%%%%%%%%%                              %%%                          
%%%%%%%%%%%%                              %%%                          
%%%%%%%%%%%%                              %%%                          
%%%%%%%%%%%%                              %%%                          
%%%%%%%%%%%                               %%%                          
%%%%%%%%%%%                               %%%                          
%%%%%%%%%%%                               %%%                          
%%%%%%%%%%%                               %%%                     %%   
%%%%%%%%%%                                %%%                   %%%%%  
%%%%%%%%%%                                %%%                 %%%%%%%% 
%%%%%%%%%%                                %%%               %%%%%%%%%% 
%%%%%%%%%                                 %%%              %%%%%%%%%%% 
%%%%%%%%%                                 %%%            %%%%%%%%%%%%  
%%%%%%%%%                                 %%%          %%%%%%%%%%%%%%  
%%%%%%%%%                                 %%%         %%%%%%%%%%%%%%%  
%%%%%%%%                                  %%%        %%%%%%%%%%%%%%%   
%%%%%%%%                                  %%%       %%%%%%%%%%%%%%%%   
%%%%%%%%                                  %%%      %%%%%%%%%%%%%%%%    
%%%%%%%                                   %%%     %%%%%%%%%%%%%%%%     
%%%%%%%                                   %%%    %%%%%%%%%%%%%%%%%     
%%%%%%%                                   %%%   %%%%%%%%%%%%%%%%%      
%%%%%%                                    %%%  %%%%%%%%%%%%%%%%%       
%%%%%%                                    %%%  %%%%%%%%%%%%%%%%        
%%%%%                                     %%%  %%%%%%%%%%%%%%%         
%%%%%                                     %%% %%%%%%%%%%%%%%%%         
%%%%%                                     %%% %%%%%%%%%%%%%%%          
%%%%                                      %%%%%%%%%%%%%%%%%%           
%%%%                                      %%%%%%%%%%%%%%%..     %%%    
%%%                                       %%%%%%%%%%%%%%%..    %%%%    
%%% %                                     %%%%%%%%%%%%%%...    %%%%    
%%%%%%%%                                  %%%%%%%%%%%%%....   %%%%     
%%%%%%%%%%                                %%%%%%%%%%%%%...   %%%%%     
%%%%%%%%%%%                               %%%%%%%%%%%%....   %%%%%     
%%%%%%%%%%%                               %%%%%%%%%%%%...   %%%%%%     
%%%%%%%%%%%%                              %%%%%%%%%%%%...   %%%%%      
%%%%%%%%%%%%                              %%%%%%%%%%%...   %%%%%%      
%%%%%%%%%%%%                              %%%%%%%%%%%...   %%%%%%      
%%%%%%%%%%%%                              %%%%%%%%%%%..   %%%%%%       
%%%%%%%%%%%%                              %%%%%%%%%%...  %%%%%%%       
%%%%%%%%%%%%                              %%%%%%%%%%%.   %%%%%%        
%%%%%%%%%%%%%                             %%%%%%%%%%%%  %%%%%%%        
%%%%%%%%%%%%                              %%%%%%%%%%%   %%%%%%         
%%%%%%%%%%%%                              %%%%%%%%%%%  %%%%%%%         
%%%%%%%%%%%%                              %%%%%%%%%%%  %%%%%%          
%%%%%%%%%%%%                             %%%%%%%%%%%   %%%%%%          
%%%%%%%%%%%%                             %%%%%%%%%%%  %%%%%%           
%%%%%%%%%%%%                            %%%%%%%%%%%%  %%%%%%           
%%%%%%%%%%%%                            %%%%%%%%%%%% %%%%%%            
%%%%%%%%%%%%                           %%%%%%%%%%%%  %%%%%%            
%%%%%%%%%%%                            %%%%%%%%%%%%  %%%%%%            
%%%%%%%%%%%                            %%%%%%%%%%%% %%%%%%             
%%%%%%%%%%%                           %%%%%%%%%%%%% %%%%%%            %
%%%%%%%%%%%                           %%%%%%%%%%%%  %%%%%            %%
%%%%%%%%%%                            %%%%%%%%%%%% %%%%%%            %%
%%%%%%%%%%                           %%%%%%%%%%%%% %%%%%            %%%
%%%%%%%%%%                           %%%%%%%%%%%%%%%%%%%            %%%
%%%%%%%%%                           %%%%%%%%%%%%% %%%%%%           %%%%
%%%%%%%%%                           %%%%%%%%%%%%% %%%%%           %%%%%
%%%%%%%%                            %%%%%%%%%%%%%%%%%%%           %%%%%
%%%%%%%%                           %%%%%%%%%%%%%%%%%%%            %%%%%
%%%%%%%%                           %%%%%%%%%%%%%%%%%%%           %%%%%%
%%%%%%%                           %%%%%%%%%%%%%%%%%%%%           %%%%%%
%%%%%%%   P                       %%%%%%%%%%%%%%%%%%%           %%%%%%%
%%%%%%                           %%%%%%%%%%%%%%%%%%%%           %%%%%%%
%%%%%%                           %%%%%%%%%%%%%%%%%%%%          %%%%%%%%
%%%%%                            %%%%%%%%%%%%%%%%%%%           %%%%%%%%
%%%%%                            %%%%%%%%%%%%%%%%%%%           %%%%%%%%
%%%%%                           %%%%%%%%%%%%%%%%%%%           %%%%%%%%%
%%%%                            %%%%%% %%%%%%%%%%%%           %%%%%%%%%
%%%                            %%%%%%% %%%%%%%%%%%%          %%%%%%%%%%
%%%                            %%%%%%%%%%%%%%%%%%%           %%%%%%%%%%
%%                             %%%%%% %%%%%%%%%%%%           %%%%%%%%%%
%%                            %%%%%%% %%%%%%%%%%%%          %%%%%%%%%%%
%                             %%%%%% %%%%%%%%%%%%           %%%%%%%%%%%
                             %%%%%%% %%%%%%%%%%%%           %%%%%%%%%%%
                             %%%%%%%%%%%%%%%%%%%            %%%%%%%%%%%
                            %%%%%%% %%%%%%%%%%%%           %%%%%%%%%%%%
                            %%%%%%% %%%%%%%%%%%%           %%%%%%%%%%%%
                           %%%%%%% %%%%%%%%%%%%            %%%%%%%%%%%%
                           %%%%%%%%%%%%%%%%%%%             %%%%%%%%%%%%
                           %%%%%% %%%%%%%%%%%%             %%%%%%%%%%%%
                          %%%%%%%%%%%%%%%%%%%%             %%%%%%%%%%%%
                          %%%%%%%%%%%%%%%%%%%              %%%%%%%%%%%%
                         %%%%%%% %%%%%%%%%%%%              %%%%%%%%%%%%
                         %%%%%%%%%%%%%%%%%%%%             %%%%%%%%%%%%%
                        %%%%%%% %%%%%%%%%%%%%              %%%%%%%%%%%%
                        %%%%%%%%.%%%%%%%%%%%%              %%%%%%%%%%%%
                       %%%%%%% ..%%%%%%%%%%%%              %%%%%%%%%%%%
                      %%%%%%%%...%%%%%%%%%%%%              %%%%%%%%%%%%
                      %%%%%%%....%%%%%%%%%%%%              %%%%%%%%%%%%
                      %%%%%%%...%%%%%%%%%%%%%              %%%%%%%%%%%%
                     %%%%%%%....%%%%%%%%%%%%%               %%%%%%%%%%%
                     %%%%%%%...%%%%%%%%%%%%%%               %%%%%%%%%%%
                     %%%%%% ...%%%%%%%%%%%%%%                %%%%%%%%%%
                    %%%%%% ....%%%%%%%%%%%%%%                  %%%%%%%%
                    %%%%%% ...%%%%%%%%%%%%%%%                     % %%%
                    %%%%% ...%%%%%%%%%%%%%%%%                       %%%
                    %%%%  ...%%%%%%%%%%%%%%%%                      %%%%
                    %%%   . %%%%%%%%%%%%%%%%%                      %%%%
                    %%     %%%%%%%%%%%%%%%%%%                     %%%%%
                          %%%%%%%%%%%%%%%%%%%                     %%%%%
                          %%%%%%%%%%%%%%%%%%%                     %%%%%
                         %%%%%%%%%%%%%%%% %%%                    %%%%%%
                        %%%%%%%%%%%%%%%%% %%%                    %%%%%%
                       %%%%%%%%%%%%%%%%%  %%%                   %%%%%%%
                      %%%%%%%%%%%%%%%%%%  %%%                   %%%%%%%
                     %%%%%%%%%%%%%%%%%%   %%%                   %%%%%%%
                     %%%%%%%%%%%%%%%%%    %%%                  %%%%%%%%
                    %%%%%%%%%%%%%%%%%     %%%                  %%%%%%%%
                    %%%%%%%%%%%%%%%%      %%%                  %%%%%%%%
                   %%%%%%%%%%%%%%%        %%%                 %%%%%%%%%
                   %%%%%%%%%%%%%%         %%%                 %%%%%%%%%
                  %%%%%%%%%%%%%%          %%%                 %%%%%%%%%
                  %%%%%%%%%%%%            %%%                 %%%%%%%%%
                  %%%%%%%%%%%             %%%                %%%%%%%%%%
                  %%%%%%%%                %%%                %%%%%%%%%%
                  %%%%%%                  %%%                %%%%%%%%%%
                   %%%                    %%%               %%%%%%%%%%%
                                          %%%               %%%%%%%%%%%
                                          %%%               %%%%%%%%%%%
                                          %%%               %%%%%%%%%%%
                                          %%%              %%%%%%%%%%%%
                                          %%%              %%%%%%%%%%%%
                                          %%%              %%%%%%%%%%%%
                                          %%%              %%%%%%%%%%%%
                                          %%%              %%%%%%%%%%%%
                                          %%%              %%%%%%%%%%%%
                                          %%%              %%%%%%%%%%%%
                                          %%%              %%%%%%%%%%%%
                                          %%%             %%%%%%%%%%%%%
                                          %%%              %%%%%%%%%%%%
                                          %%%              %%%%%%%%%%%%
                                          %%%              %%%%%%%%%%%%
                                          %%%              %%%%%%%%%%%%
                                          %%%              %%%%%%%%%%%%
                                          %%%              %%%%%%%%%%%%
                                          %%%               %%%%%%%%%%%
                                          %%%               %%%%%%%%%%%
